111111111111111111111111111111
102020202020020020020202020201
100000000000000000000000000001
102020202020020020020202020201
100000000000000000000000000001
102020202020020020020202020201
100000000000000000000000000001
102020202020020020020202020201
100000000000000000000000000001
102020202020020020020202020201
100000000000000000000000000001
102020202020020020020202020201
100000000000000000000000000001
102020202020020020020202020201
111111111111111111111111111111